NO ./path_to_the_north_texture.xpm
SO ./path_to_the_south_texture.xpm
EA ./path_to_the_east_texture.xpm
WE ./path_to_the_west_texture.xpm

F 255,255,255
C 0,0,0

1111111111111111111111111111111111111111111111111111111111111111111111111111111111111111
1000000000000000011111100000000000000000000000000011111110000000000000000000000000000001
1011111111111101010000101111111111110111111111101010000010111111111111111111111111111101
1000000000000101010110101000000000010000000000101010110101000000000000000000000000000101
1111111111101101010101101011111111011111111101101010101101111111111111111111111111110101
1000000000100001010100001010000001000000000100001010100000000000000000000000000000010101
1011111101101111010111101010111101011111101101111010111111111111111111111111111111010101
1010000000000000010100001010100000000W00000000000010100000000000000000000000000001010101
1010111111111111010101111010111111111111111111111010101111111111111111111111111101010101
1010100000000000010000010000000000000000000000000010000000000000000000000000000001010101
1011101111111101111010111111111111111111111111101111010111111111111111111111111101010101
1000000000000100000010000000000000000000000000100000010000000000000000000000000001010101
1011111111101101111011111111111111111111111101101111011111111111111111111111111101010101
1010000000000000000010000000000000000000000000000000010000000000000000000000000001010101
1010111111111111111011111111111111111111111111111111011111111111111111111111111101010101
1010100000000000000010000000000000000000000000000000010000000000000000000000000001010101
1011101111111111111011111111111111111111111111111111011111111111111111111111111101010101
1000000000000000000010000000000000000000000000000000010000000000000000000000000001010101
1011111111111111111011111111111111111111111111111111011111111111111111111111111101010101
1000000000000000000000000000000000000000000000000000000000000000000000000000000000010001
1111111111111111111111111111111111111111111111111111111111111111111111111111111111111111

