NO textures/eagle.xpm
SO textures/eagle.xpm
EA textures/eagle.xpm
WE textures/eagle.xpm

 F 55,255,255
C 0,0,0

     111
    10W11
    1111111
11111111111111
