NO textures/eagle.xpm
SO textures/eagle.xpm
EA textures/eagle.xpm
WE textures/eagle.xpm

F 255,255,255
C 0,0,11

11111
10W01
11111

