NO ./path_to_the_north_texture.xpm
SO       ./path_to_the_south_texture.xpm
EA  ./path_to_the_east_texture.xpm
  

F 220,200,40
    WE ./path_to_the_west_texture.xpm
C 225,30,   100

    1111111111111111111111111111111            
    11111000000000001000000000011111111111111111111
11111100000000000010000000000000010000000000001
10000000000000010000000000000000000000000000001
10000000000000000000000000000000000000000000001
11000000000001111111000000000111111111111111111
1110000000001      1000000000010000000000000001
11000000000001111110000000000100000000000000001
100000E0000000001000000000000000000000000000001
10000000000000010000000000000010000000000000001
10000000000000010000000000000010000000000000001
11111111111111111111111111111111111111111111111



