NO ./path_to_the_north_texture.xpm
SO ./path_to_the_south_texture.xpm
WE ./path_to_the_west_texture.xpm
EA ./path_to_the_east_texture.xpm

F 220,200,40
C 225,30   ,100

//rows
111111111111111111111111111111
1000000000000001000000000000001111111111111111111111111111
1000000000000001000000000000001000000000000000000000000001
1000000000000001000000000000000000000000000000000000000001
1000000000000000000000000000000000000000000000000000000001
10000000000000000E0000000000011111111111111111111111111111
1000000000000000000000000000001000000000000000000000000001
1000000000000001000000000000001000000000000000000000000001
1000000000000001000000000000000000000000000000000000000001
1000000000000001000000000000001000000000000000000000000001
1000000000000001000000000000001000000000000000000000000001
1111111111111111111111111111111111111111111111111111111111
