1111111111111111111111111111111
1000000000000001000000000000001111111111111111111111111111
1000000000000001000000000000001000000000000000000000000001
1000000000000001000000000000000000000000000000000000000001
1000000000000000000000000000000000000000000000000000000001
10000000000000N0000000000000001111111111111111111111111111
1000000000000000000000000000001000000000000000000000000001
1000000000000001000000000000001000000000000000000000000001
1000000000000001000000000000000000000000000000000000000001
1000000000000001000000000000001000000000000000000000000001
1000000000000001000000000000001000000000000000000000000001
1111111111111111111111111111111111111111111111111111111111