NO ./path_to_the_north_texture.xpm
SO ./path_to_the_south_texture.xpm
WE ./path_to_the_west_texture.xpm
EA ./path_to_the_east_texture.xpm


F 220,200,40
C 225,30   ,100


111111111111111111111111111111  
1111100000000000100000000001111111111111111111111111111
1000000000000001000000000000001000000000000000000000001
1000000000000001000000000000000000000000000000000000001111
1000000000000000000000000000000000000000000000000000000001
1100000000000111111100000000011111111111111111111111111111
1110000000001      100000000001000000000000000000000000001
1100E0000000011111100000000001000000000000000000000000001
1000000000000001000000000000000000000000000000000000000001
1000000000000001000000000000001000000000000000000000000001
1000000000000001000000000000001000000000000000000000000001
1111111111111111111111111111111111111111111111111111111111