1111111111111111111111111111111
1000000000000001000000000000001111111111111111111111111111
1000000000000001000000000000001000000000000000000000000001
1000001111100001000000000001101000000000000000000000000001
1000000110000000000000000000000000000000000000000000000001
100000000000000W000000000000001111111111111111111111111111
1000000000000000000000000000001000001000000000000000000001
1000000000000001111111100000001000001000000000000000000001
1000000000000001000000000000000000001111100000000000000001
1000000000000001000000000000001000000000100000000000000001
1000000000000001000000000000001000000000000000000000000001
1111111111111111111111111111111111111111111111111111111111