
NO textures/barrel.xpm
SO textures/bluestone.xpm
EA textures/colorstone.xpm


F 255,255,250
C 13,25    ,0

11111111111111111111111111111111111111111111111111111111111111111111111111111111111111111
11000000000000000011111100000000000000000000000000011111110000000000000000000000000000001
11011111111111101010000101111111111110111111111101010000010111111111111111111111111111101
11000000000000101010110101000000000010000000000101010110101000000000000000000000000000101
11111111111101101010101101011111111011111111101101010101101111111111111111111111111110101
11000000000100001010100001010000001000000000100001010100000000000000000000000000000010101
11011111101101111010111101010111101011111101101111010111111111111111111111111111111010101
11010000000000000010100001010100000000000000000000010100000000000000000000000000001010101
11010111111111111010101111010111111111111111111111010101111111111111111111111111101010101
11010100000000000010000010000000000000000000000000010000000000000000000000000000001010101
11011101111111101111010111111111111111111111111101111010111111111111111111111111101010101
11000000000000100000010000000000000000000000000100000010000000000000000000000000001010101
11011111111101101111011111111111111111111111101101111011111111111111111111111111101010101
1101000000000000000001000000000000000S000000000000000010000000000000000000000000001010101
11010111111111111111011111111111111111111111111111111011111111111111111111111111101010101
11010100000000000000010000000000000000000000000000000010000000000000000000000000001010101
11011101111111111111011111111111111111111111111111111011111111111111111111111111101010101
11000000000000000000010000000000000000000000000000000010000000000000000000000000001010101
11011111111111111111011111111111111111111111111111111011111111111111111111111111101010101
11000000000000000000000000000000000000000000000000000000000000000000000000000000000000001
11011111111111111111111111111111111111111111111111111111111111111111111111111111111111111
11111111111111111111111111111111111111111111111111111111111111111111111111111111111111111
11000000000000000011111100000000000000000000000000011111110000000000000000000000000000001
11011111111111101010000101111111111110111111111101010000010111111111111111111111111111101
11000000000000101010110101000000000010000000000101010110101000000000000000000000000000101
11111111111011010101011010111111110111111111011010101011011111111111111111111111111101011
11000000000100001010100001010000001000000000100001010100000000000000000000000000000010101
11011111101101111010111101010111101011111101101111010111111111111111111111111111111010101
11010000000000000010100001010100000000000000000000010100000000000000000000000000001010101
11111111111111111111111111111111111111111111111111111111111111111111111111111111111111111


WE textures/eagle.xpm
