
NO textures/barrel.xpm
SO textures/bluestone.xpm
EA textures/colorstone.xpm
WE textures/eagle.xpm

F 255,255,250
C 13,25    ,0

1111111111111111111111111111111111111111111111111111111111111111111111111111111111111111
1000000000000000011111100000000000000000000000000011111110000000000000000000000000000001
1011111111111101010000101111111111110111111111101010000010111111111111111111111111111101
1000000000000101010110101000000000010000000000101010110101000000000000000000000000000101
1111111111101101010101101011111111011111111101101010101101111111111111111111111111110101
1000000000100001010100001010000001000000000100001010100000000000000000000000000000010101
1011111101101111010111101010111101011111101101111010111111111111111111111111111111010101
1010000000000000010100001010100000000000000000000010100000000000000000000000000001010101
1010111111111111010101111010111111111111111111111010101111111111111111111111111101010101
1010100000000000010000010000000000000000000000000010000000000000000000000000000001010101
1011101111111101111010111111111111111111111111101111010111111111111111111111111101010101
1000000000000100000010000000000000000000000000100000010000000000000000000000000001010101
1011111111101101111011111111111111111111111101101111011111111111111111111111111101010101
1010000000000000000010000000000000000000000000000000010000000000000000000000000001010101
1010111111111111111011111111111111111111111111111111011111111111111111111111111101010101
1010100000000000000010000000000000000000000000000000010000000000000000000000000001010101
1011101111111111111011111111111111111111111111111111011111111111111111111111111101010101
1000000000000000000010000000000000000000000000000000010000000000000000000000000001010101
1011111111111111111011111111111111111111111111111111011111111111111111111111111101010101
1000000000000000000000000000000000000000000000000000000000000000000000000000000000000001
1011111111111111111111111111111111111111111111111111111111111111111111111111111111111111
1111111111111111111111111111111111111111111111111111111111111111111111111111111111111111
1000000000000000011111100000000000000000000000000011111110000000000000000000000000000001
1011111111111101010000101111111111110111111111101010000010111111111111111111111111111101
1000000000000101010110101000000000010000000000101010110101000000000000000000000000000101111111111111111111111111111111111111111111111111111111111111111111111111111111111111111111111111111111111111111111111111111111111111111111111111111111111111111111111111111111111111111111111111111111111111111111111111111111111111111111111111111111111111111111111111111111111111111111111111111111111111111111111111111111111111111111111111111111111111111111111111111111111111111111111111111111111111111111111111111111111111111111111111111111111111111111111111111111111111111111111111111111111111111111111111
1111111111101101010101101011111111011111111101101010101101111111111111111111111111110101
1000000000100001010100001010000001000000000100001010100000000000000000000000000000010101
1011111101101111010111101010111101011111101101111010111111111111111111111111111111010101
1010000000000000010100001010100000000000000000000010100000000000000000000000000001010101
1010111111111111010101111010111111111111111111111010101111111111111111111111111101010101
1010100000000000010000010000000000000000000000000010000000000000000000000000000001010101
1011101111111101111010111111111111111111111111101111010111111111111111111111111101010101
1000000000000100000010000000000000000000000000100000010000000000000000000000000001010101
1011111111101101111011111111111111111111111101101111011111111111111111111111111101010101
1010000000000000000010000000000000000000000000000000010000000000000000000000000001010101
1010111111111111111011111111111111111111111111111111011111111111111111111111111101010101
1010100000000000000010000000000000000000000000000000010000000000000000000000000001010101
1011101111111111111011111111111111111111111111111111011111111111111111111111111101010101
1000000000000000000010000000000000000000000000000000010000000000000000000000000001010101
1011111111111111111011111111111111111111111111111111011111111111111111111111111101010101
1000000000000000000000000000000000000000000000000000000000000000000000000000000000000001
1011111111111111111111111111111111111111111111111111111111111111111111111111111111111111
1111111111111111111111111111111111111111111111111111111111111111111111111111111111111111
1000000000000000011111100000000000000000000000000011111110000000000000000000000000000001
1011111111111101010000101111111111110111111111101010000010111111111111111111111111111101
1000000000000101010110101000000000010000000000101010110101000000000000000000000000000101
1111111111101101010101101011111111011111111101101010101101111111111111111111111111110101
1000000000100001010100001010000001000000000100001010100000000000000000000000000000010101
1011111101101111010111101010111101011111101101111010111111111111111111111111111111010101
1010000000000000010100001010100000000000000000000010100000000000000000000000000001010101
1010111111111111010101111010111111111111111111111010101111111111111111111111111101010101
1010100000000000010000010000000000000000000000000010000000000000000000000000000001010101
1011101111111101111010111111111111111111111111101111010111111111111111111111111101010101
1000000000000100000010000000000000000000000000100000010000000000000000000000000001010101
1011111111101101111011111111111111111111111101101111011111111111111111111111111101010101
1010000000000000000010000000000000000000000000000000010000000000000000000000000001010101
1010111111111111111011111111111111111111111111111111011111111111111111111111111101010101
1010100000000000000010000000000000000000000000000000010000000000000000000000000001010101
1011101111111111111011111111111111111111111111111111011111111111111111111111111101010101
1000000000000000000010000000000000000000000000000000010000000000000000000000000001010101
1011111111111111111011111111111111111111111111111111011111111111111111111111111101010101
1000000000000000000000000000000000000000000000000000000000000000000000000000000000000001
1011111111111111111111111111111111111111111111111111111111111111111111111111111111111111
1111111111111111111111111111111111111111111111111111111111111111111111111111111111111111
1000000000000000011111100000000000000000000000000011111110000000000000000000000000000001
1011111111111101010000101111111111110111111111101010000010111111111111111111111111111101
1000000000000101010110101000000000010000000000101010110101000000000000000000000000000101
1111111111101101010101101011111111011111111101101010101101111111111111111111111111110101
1000000000100001010100001010000001000000000100001010100000000000000000000000000000010101
1011111101101111010111101010111101011111101101111010111111111111111111111111111111010101
1010000000000000010100001010100000000000000000000010100000000000000000000000000001010101
1010111111111111010101111010111111111111111111111010101111111111111111111111111101010101
1010100000000000010000010000000000000000000000000010000000000000000000000000000001010101
1011101111111101111010111111111111111111111111101111010111111111111111111111111101010101
1000000000000100000010000000000000000000000000100000010000000000000000000000000001010101
1011111111101101111011111111111111111111111101101111011111111111111111111111111101010101
1010000000000000000010000000000000000000000000000000010000000000000000000000000001010101
1010111111111111111011111111111111111111111111111111011111111111111111111111111101010101
1010100000000000000010000000000000000000000000000000010000000000000000000000000001010101
1011101111111111111011111111111111111111111111111111011111111111111111111111111101010101
1000000000000000000010000000000000000000000000000000010000000000000000000000000001010101
1011111111111111111011111111111111111111111111111111011111111111111111111111111101010101
1000000000000000000000000000000000000000000000000000000000000000000000000000000000000001
1011111111111111111111111111111111111111111111111111111111111111111111111111111111111111
1111111111111111111111111111111111111111111111111111111111111111111111111111111111111111
1000000000000000011111100000000000000000000000000011111110000000000000000000000000000001
1011111111111101010000101111111111110111111111101010000010111111111111111111111111111101
1000000000000101010110101000000000010000000000101010110101000000000000000000000000000101
1111111111101101010101101011111111011111111101101010101101111111111111111111111111110101
1000000000100001010100001010000001000000000100001010100000000000000000000000000000010101
1011111101101111010111101010111101011111101101111010111111111111111111111111111111010101
1010000000000000010100001010100000000000000000000010100000000000000000000000000001010101
1010111111111111010101111010111111111111111111111010101111111111111111111111111101010101
1010100000000000010000010000000000000000000000000010000000000000000000000000000001010101
1011101111111101111010111111111111111111111111101111010111111111111111111111111101010101
1000000000000100000010000000000000000000000000100000010000000000000000000000000001010101
1011111111101101111011111111111111111111111101101111011111111111111111111111111101010101
1010000000000000000010000000000000000000000000000000010000000000000000000000000001010101
1010111111111111111011111111111111111111111111111111011111111111111111111111111101010101
1010100000000000000010000000000000000000000000000000010000000000000000000000000001010101
1011101111111111111011111111111111111111111111111111011111111111111111111111111101010101
1000000000000000000010000000000000000000000000000000010000000000000000000000000001010101
1011111111111111111011111111111111111111111111111111011111111111111111111111111101010101
1000000000000000000000000000000000000000000000000000000000000000000000000000000000000001
1011111111111111111111111111111111111111111111111111111111111111111111111111111111111111
1111111111111111111111111111111111111111111111111111111111111111111111111111111111111111
1000000000000000011111100000000000000000000000000011111110000000000000000000000000000001
1011111111111101010000101111111111110111111111101010000010111111111111111111111111111101
1000000000000101010110101000000000010000000000101010110101000000000000000000000000000101
1111111111101101010101101011111111011111111101101010101101111111111111111111111111110101
1000000000100001010100001010000001000000000100001010100000000000000000000000000000010101
1011111101101111010111101010111101011111101101111010111111111111111111111111111111010101
1010000000000000010100001010100000000000000000000010100000000000000000000000000001010101
1010111111111111010101111010111111111111111111111010101111111111111111111111111101010101
1010100000000000010000010000000000000000000000000010000000000000000000000000000001010101
1011101111111101111010111111111111111111111111101111010111111111111111111111111101010101
1000000000000100000010000000000000000000000000100000010000000000000000000000000001010101
1011111111101101111011111111111111111111111101101111011111111111111111111111111101010101
1010000000000000000010000000000000000000000000000000010000000000000000000000000001010101
1010111111111111111011111111111111111111111111111111011111111111111111111111111101010101
1010100000000000000010000000000000000000000000000000010000000000000000000000000001010101
1011101111111111111011111111111111111111111111111111011111111111111111111111111101010101
1000000000000000000010000000000000000000000000000000010000000000000000000000000001010101
1011111111111111111011111111111111111111111111111111011111111111111111111111111101010101
1000000000000000000000000000000000000000000000000000000000000000000000000000000000000001
1011111111111111111111111111111111111111111111111111111111111111111111111111111111111111
101
101
101
101
101
101
101
10111111111111111111111111111111111111111111111111111111111111111111111111111111111111111111111111111111111111111111111111111111111111111111111111111111111111111111111111111111111111111111111111111111111111111111111111111111111111111111111111111111111111111111111111111111111111
10000000000000000111111000000000000000000000000000111111100000000000000000000000000000010000000000000000000000000000000000000000000000000000000000000000000000000000000000000000000000000000000000000000000000000000000000000000000000000000000000000000000000000000000000000000000001
1111111111111111111111111111111111111111111111111111111111111111111111111111111111111111111111111111111111111111111111111111111111111111111111111111111111111111111111111111111111111111111111111111111111111111111111111111111111111111111111111111111111111111111111111111111111111111111111111
1011111111111101010000101111111111110111111111101010000010111111111111111111111111111101
1000000000000101010110101000000000010000000000101010110101000000000000000000000000000101
1111111111101101010101101011111111011111111101101010101101111111111111111111111111110101
1000000000100001010100001010000001000000000100001010100000000000000000000000000000010101
1011111101101111010111101010111101011111101101111010111111111111111111111111111111010101
1010000000000000010100001010100000000000000000000010100000000000000000000000000001010101
1010111111111111010101111010111111111111111111111010101111111111111111111111111101010101
1010100000000000010000010000000000000000000000000010000000000000000000000000000001010101
1011101111111101111010111111111111111111111111101111010111111111111111111111111101010101
1000000000000100000010000000000000000000000000100000010000000000000000000000000001010101
1011111111101101111011111111111111111111111101101111011111111111111111111111111101010101
1010000000000000000010000000000000000000000000000000010000000000000000000000000001010101
1010111111111111111011111111111111111111111111111111011111111111111111111111111101010101
1010100000000000000010000000000000000000000000000000010000000000000000000000000001010101
1011101111111111111011111111111111111111111111111111011111111111111111111111111101010101
1000000000000000000010000000000000000000000000000000010000000000000000000000000001010101
1011111111111111111011111111111111111111111111111111011111111111111111111111111101010101
10000000000000000W0000000000000000000000000000000000000000000000000000000000000000000001
1111111111111111111111111111111111111111111111111111111111111111111111111111111111111111