











NO textures2/1.xpm 
SO textures2/2.xpm 
EA textures2/3.xpm
WE textures/eagle.xpm


F 0,0,0
C 0,0,0

  1111111111111111111111111111111                                        
    11111000000000001000000000011111111111111111111
1111100000000S00010000000000000010000000000001
10000000000000010000000000000000000000000000001
1000000000000000000000000000000000000000000001
1100000000000111111000000000111111111111111111
1110000000001      1000000000010000000000000001
1100000000000111111000000000100000000000000001
10000000000000001000000000000000000000000000001
10000000000000010000000000000010000000000000001
10000000000000010000000000000010000000000000001
11111111111111111111111111111111111111111111111
